S.............#.
#........#...##
#.#.#........#.
#.#.###..#.....
#.#.#.##.#.....
#.###....#...##
#.#.#....######
#.#.#....#.....
#...#....#...##
#.#.#.##.#...##
#...#....#.....
#.#.#....#...##
#...#.##.#...##
#...#.##.#...##
#...#....#...#X