S...###..#...#.
#...#........##
..#....##....#.
#.#.##...#.....
..#.#.##.#.....
#.###....#...##
#.#.#....#..###
..#.#...##.....
....#....#...##
..#.#.#......##
#...#....#.....
#.#.#........#.
#...#.##.#.....
#...#.##.#....#
#...#....#....X