S...#..##......
#........#...##
..#..........#.
..#..##..#.....
#.#...##.#.....
...#.....#...##
#.#.#....##..##
#.#.#....#.....
..#.....#.....#
....#.#..#..#..
#...#....#.....
#..............
#...#....#...##
#...#.#..#.....
#...#....#....X